[console_scripts]
gen-csv=linkml.generators.csvgen:cli
gen-doc=linkml.generators.docgen:cli
gen-erdiagram=linkml.generators.erdiagramgen:cli
gen-excel=linkml.generators.excelgen:cli
gen-golang=linkml.generators.golanggen:cli
gen-golr-views=linkml.generators.golrgen:cli
gen-graphql=linkml.generators.graphqlgen:cli
gen-graphviz=linkml.generators.dotgen:cli
gen-java=linkml.generators.javagen:cli
gen-json-schema=linkml.generators.jsonschemagen:cli
gen-jsonld=linkml.generators.jsonldgen:cli
gen-jsonld-context=linkml.generators.jsonldcontextgen:cli
gen-linkml=linkml.generators.linkmlgen:cli
gen-markdown=linkml.generators.markdowngen:cli
gen-namespaces=linkml.generators.namespacegen:cli
gen-owl=linkml.generators.owlgen:cli
gen-plantuml=linkml.generators.plantumlgen:cli
gen-prefix-map=linkml.generators.prefixmapgen:cli
gen-project=linkml.generators.projectgen:cli
gen-proto=linkml.generators.protogen:cli
gen-py-classes=linkml.generators.pythongen:cli
gen-pydantic=linkml.generators.pydanticgen:cli
gen-python=linkml.generators.pythongen:cli
gen-rdf=linkml.generators.rdfgen:cli
gen-shacl=linkml.generators.shaclgen:cli
gen-shex=linkml.generators.shexgen:cli
gen-sparql=linkml.generators.sparqlgen:cli
gen-sqla=linkml.generators.sqlalchemygen:cli
gen-sqlddl=linkml.generators.sqltablegen:cli
gen-sqltables=linkml.generators.sqltablegen:cli
gen-sssom=linkml.generators.sssomgen:cli
gen-summary=linkml.generators.summarygen:cli
gen-terminusdb=linkml.generators.terminusdbgen:cli
gen-typescript=linkml.generators.typescriptgen:cli
gen-yaml=linkml.generators.yamlgen:cli
gen-yuml=linkml.generators.yumlgen:cli
linkml=linkml.cli.main:linkml
linkml-convert=linkml.utils.converter:cli
linkml-jsonschema-validate=linkml.validators.jsonschemavalidator:cli
linkml-lint=linkml.linter.cli:main
linkml-run-examples=linkml.workspaces.example_runner:cli
linkml-schema-fixer=linkml.utils.schema_fixer:main
linkml-sparql-validate=linkml.validators.sparqlvalidator:cli
linkml-sqldb=linkml.utils.sqlutils:main
linkml-validate=linkml.validator.cli:cli
run-tutorial=linkml.utils.execute_tutorial:cli

